%%%%%%%%%%%%%%%%%%%%%%%%%%%%%%
%.                          .%
%           %%%%%% %%%%%%%%% %
% P                          %
%%%%% %%%%% %%% %% %%%%% % %%%
%   % %   %   %    %     %   %
% %%% %   % %%%%%%%% %%% %%% %
%             %%     % % %   %
%%% % %%%%%%% %%%% %%% % % % %
% %           %%     %     % %
% % %%%%% % %%%% % %%% %%% % %
%   %     %      % %   % %%% %
%.  % %%%%%      % %%% %    .%
%%%%%%%%%%%%%%%%%%%%%%%%%%%%%%