%%%%%%%%%%%%%%%%%%%%
%P                 %
%%%%%%%%%%  %%%%%%%%
%                  %
%%%%%  %%%%%%%%%%%%%
%.                .%
%%%%%%%%%%%%%%%%%%%%
