%%%%%%%%%%%%%%%%%%%%%%%%%%%%%%
%.                          .%
%       % % %%%%%%o%%%%%%% % %
%       %        %     % %   %
%%%%% %%%%% %%%%%% %%%%% % %%%
%   % %   %   %    %     %   %
%%%%% % % % %%%%%%%% %%% %%% %
%     P       %%     % % %   %
%%%%% %%%%%%% %%%% %%% % % % %
% %           %%     %     % %
% % %%%%% % %%%% % %%% %%% % %
%   %     %      % %   % %%% %
%.  % %%%%%      % %%% %    .%
%%%%%%%%%%%%%%%%%%%%%%%%%%%%%%