%%%%%%%%%%%%%%%%%%%%%%%%%%%%%%%
%.    %            P %       o%
%     %      %%%%% %%%%%%%%%  %
%                             %
%%%%% %%%%  %% %% %%%%%  %%% %%
%   % %  %   %                %
% %%% %  % %%%%%  % %%%  %%%  %
%             %%     % %      %
%%% % %%%%%%% %%%% %%% %%  %% %
%.%                       %   %
% %              % %      %   %
% % %%%%% % %%%% % %%% %% %%%%%
%   %     %      %            %
%   % %%%%%      % %%% %     o%
%%%%%%%%%%%%%%%%%%%%%%%%%%%%%%%